11122111111111111111111111111111111111111111111111111111111111
11112211111111111111111111111111111111111111111111111111111111
11111221111111111111333333333333333333333333333333311111111111
11111221111000111111311111111111111122111111111111111111111111
11111122110001111111311111111111111122111111111111111111111111
11111122211111111113331111111111111122111111111111111111111111
11111112211111111113331111111111111221111111111111111111111111
11111112211100011111311111111111222211111111111111111111111111
11111112211111111111311111122222211111111111111111111111111111
11111111221111111222322212221111221111111111111111111111111111
11111111122222222212321222111111122111111111111111111111111111
11111111111111111111311111111111122111111111114444444444441111
11111111111111111111311111111111122111111111144444444441111111
11111111111133333333311111111111122111111111111444444444441111
11111111111111111111111111111111221111111111144444444444444441
1111111111111111111111111111111221111111111
1111111110000111111111111111111221111114444
1111111100011111111111111111112222111111444
1111111111111111111111111111122222221111144
1111111111111000111111111111112222111144444
1111111111111110011111111111111111114444444
1111111111111111000011111100011144444444444
1111111111111100000000000000111111144444444
1111111111111111110000000111111111111114444
11111111111111111111100000111111111111111111111111444444444444
11111111111111111111111111111111111111111111111111111111111111
11111111111111111111111111111111111111111111111111111111111111
11111111111111111111111111111111111111111111111111111111111111
11111111111111111111111111111111111111111111111111111111111111
11111111111111111111111111111111111111111111111111111111111111
-
0,1,1
1,1,1
1,15,15
1,7,0
1,15,2
2,14,2
1,6,6
1,5,4 
2,9,2 
1,1,10
1,12,1
2,15,9 
2,11,1
1,22,9 
1,22,1
2,23,20
1,2,8 
2,15,15
1,17,1 
1,1,15
2,9,8
2,18,30
2,29,27
2,29,15
2,28,30
2,20,19
2,15,29
2,27,17
2,15,15
2,24,26
2,25,22
2,22,19
2,27,25
2,30,19
2,25,21
2,30,20
2,20,19
2,26,25
2,17,27
2,29,24
2,27,25
1,38,9
1,30,4
1,50,24
1,39,9
1,49,23
1,37,10
1,40,25
1,46,14
1,48,13
1,43,14
1,50,27
1,44,17
1,45,12
1,32,28
1,44,15
1,35,18
1,34,14
1,47,3
1,37,11
1,38,26