11111111111311122111111000
11111110011311122111111100
11111000111311122111111111
11110001111311122111111111
33333333333311112211111111
11111111111311111221111111
11111111111311111122111111
11111111113331111122111111
11112221113333333333333333
11122222113331111122111111
11112221111111111221111111
11111122222222222211111111
11111111111221111111111111
11111000112211111111111111
11111001122111100000011111
11111111122111000000111111
11111111122111100001111111
11111111002211111111111111
11111111101221111111111111
11111111111122111111111111
-
8,5,1,Albert,player.png,albert.npc
8,9,1,Burt,player.png,sally.npc
0,11,7
3,11,0,volcano.map,16,23
4,25,8,forest_center.map,1,12
1,0,0 
1,7,2 
1,14,9
1,13,12
1,20,9 
1,22,1
1,24,12
1,2,8 
1,15,15
1,17,1 
1,1,15
2,8,8