11111111111111122111111000
11111110011111122111111100
11111000111111122111111111
11110001111111122111111111
33333333333311112211111111
11111111111311111221111111
11111111111311111122111111
11111111113331111122111111
11112221113333333333333333
11122222113331111122111111
11112221111111111221111111
11111122222222222211111111
11111111111221111111111111
11111000112211111111111111
11111001122111100000011111
11111111122111000000111111
11111111122111100001111111
11111111002211111111111111
11111111101221111111111111
11111111111122111111111111
-
0,5,5
1,0,0 
1,7,2 
1,1,10
1,12,1
1,14,9 
1,12,1
1,13,12
1,20,9 
1,22,1
1,24,12
1,2,8 
1,15,15
1,17,1 
1,1,15
2,8,8