4444444444644644444
4433334444444444444
4434404444446444444
4430004444464444444
4434444444664444644
4434444444644466644
4430444444644466444
0034444444666644444
4034444444444644444
-
0,2,1
5,2,8,start.map,11,1