444444446666666666666666644444444444444444
444444466666666666666666666444444444444444
444446666666666666666666666666444444444444
444446666666666666666666666666444444444444
444444666666666666666666666644444444444444
444446666666666666666666666666444444444444
444446666666666666666666666666444444444444
444444666666666666666666666666444444444444
444446666666666666666666666666444444444444
444446666666666666666666666666444444444444
444444666666666666666666666664444444444444
444446666666666666666666666664444444444444
444444446666666666666666666664444444444444
444444446666666666666666666644444444444444
444444446666666666666666666644444444444444
444444446666666666666666446444444444444444
444444444444466666444666664444444444444444
444444444444444443333333333333333344444444
444444444444444443444666444444444444444444
444444444444444443444464444444444444444444
444444444444444433444444444444444444444444
444444444444444434444444444444444444444444
444444444444444434444444444444444444444444
444444444444444434444444444444444444444444
444444444444444434444444444444444444444444
444444444444444434444444444444444444444444
-
0,2,1
5,16,25,forest.map,11,1
2,15,2
2,14,2
2,6,6
2,5,4 
2,9,2 
2,1,10
2,12,1
2,15,9 
2,11,1
2,20,9 
2,22,1
2,23,20
2,2,8 
2,15,15
2,17,1 
2,1,15
2,9,8
2,18,30
2,29,27
2,29,15