444444446666666666666666644444444444444444
444444466666666666666666666444444444444444
444446666666666666666666666666444444444444
444446666666666666666666666666444444444444
444444666666666666666666666644444444444444
444446666666666666666666666666444444444444
444446666666666666666666666666444444444444
444444666666666666666666666666444444444444
444446666666666666666666666666444444444444
444446666666666666666666666666444444444444
444444666666666666666666666664444444444444
444446666666666666666666666664444444444444
444444446666666666666666666664444444444444
444444446666666666666666666644444444444444
444444446666666666663666666644444444444444
444444446666666666663646446444444444444444
444444444444466666443644464444444444444444
444444444444444443333644644444444444444444
444444444444444443444646444444444444444444
444444444444444443444444444444444444444444
444444444444444433444444444444444444444444
444444444444444434444444444444444444444444
444444444444444434444444444444444444444444
444444444444444434444444444444444444444444
444444444444444434444444444444444444444444
444444444444444434444444444444444444444444
-
0,2,1
5,16,25,forest.map,11,1