00000000011111100000000000
00000011111111100000000000
00111111111111100000000000
00001111111111100000000000
00000000111111100000000000
00000000001111100000000000
00111111111111100000000000
00000000011111100000000000
00000011111111100000000000
00111111111111100000000000
00001111111111100000000000
00000000111111100000000000
00000000001111100000000000
00111111111111100000000000
22222222222222222222222222
22222222222222222222222222
22222222222222222222222222
22222222222222222222222222
22222222222222222222222222
22222222222222222222222222